S . . # .
# # . # .
. . . . .
. # # # .
. . . G .
